................................
................................
....#####.......................
....#####.......................
....#####.......................
....#####.......................
#########.......................
#########.......................
................................
......................####......
......................####......
........##################......
........##############..........
................................
................................
................................
.............#########..........
.............#########..........
.............#########..........
.............#########..........
.............#########..........
.............#########..........
................................
................................
................................
................................
................................
................................
................................
................................
................................
................................