................................
................................
....#####.......................
....#####.......................
....#####.......................
....#####.......................
....#####.......................
....#####.......................
................................
................................
................................
........##############..........
........##############..........
................................
................................
................................
.............#########..........
.............#########..........
.............#########..........
.............#########..........
.............#########..........
.............#########..........
................................
................................
................................
................................
................................
................................
................................
................................
................................
................................